{
    "data": [
        {
            "data": [
                [1,1,1,1,1],
                [1,0,0,0,1],
                [1,0,0,2,1],
                [1,0,0,0,1],
                [1,1,1,1,1]
            ],
            "cords": {
                "start": [1,2],
                "end": [3,2]
            }
        },
        {
            "data": [
                [1,1,1,1,1,1,1],
                [1,0,1,0,0,0,1],
                [1,0,1,0,1,0,1],
                [1,0,1,0,1,0,1],
                [1,0,1,0,1,0,1],
                [1,0,0,0,1,2,1],
                [1,1,1,1,1,1,1]
            ],
            "cords": {
                "start": [1,1],
                "end": [5,5]
            }
        },
        {
            "data": [
                [1, 1, 1, 1, 1, 1, 1, 1, 1, 1, 1, 1, 1, 1],
                [1, 0, 1, 0, 0, 0, 1, 0, 1, 0, 1, 0, 0, 1],
                [1, 0, 1, 0, 1, 0, 1, 0, 1, 0, 0, 0, 0, 1],
                [1, 0, 1, 0, 1, 0, 0, 0, 1, 0, 1, 0, 2, 1],
                [1, 0, 0, 0, 1, 0, 1, 0, 1, 0, 1, 0, 0, 1],
                [1, 0, 1, 0, 1, 0, 1, 0, 0, 0, 1, 0, 0, 1],
                [1, 1, 1, 1, 1, 1, 1, 1, 1, 1, 1, 1, 1, 1]
            ],
            "cords": {
                "start": [1,1],
                "end": [12,3]
            }
        },
        {
            "data": [
                [1, 1, 1, 1, 1, 1, 1, 1, 1, 1, 1, 1, 1, 1, 1, 1],
                [1, 0, 0, 1, 1, 1, 1, 1, 1, 1, 1, 1, 1, 0, 0, 1],
                [1, 0, 0, 1, 1, 1, 1, 0, 0, 0, 1, 1, 1, 0, 0, 1],
                [1, 0, 0, 1, 1, 1, 1, 0, 1, 0, 0, 0, 0, 0, 0, 1],
                [1, 0, 0, 1, 1, 1, 1, 0, 1, 1, 1, 1, 1, 0, 2, 1],
                [1, 0, 0, 1, 1, 1, 1, 0, 1, 1, 1, 1, 1, 0, 0, 1],
                [1, 0, 0, 0, 0, 0, 1, 0, 1, 1, 1, 1, 1, 0, 0, 1],
                [1, 0, 0, 1, 1, 0, 0, 0, 1, 1, 1, 1, 1, 0, 0, 1],
                [1, 1, 1, 1, 1, 1, 1, 1, 1, 1, 1, 1, 1, 1, 1, 1]
            ],
            "cords": {
                "start": [1,4],
                "end": [14,4]
            }
        },
        {
            "data":[
                [1, 1, 1, 1, 1, 1, 1, 1, 1, 1, 1, 1, 1, 1, 1, 1, 1, 1, 1, 1, 1, 1, 1, 1],
                [1, 0, 1, 0, 1, 1, 0, 0, 0, 1, 0, 0, 0, 1, 0, 1, 1, 1, 0, 0, 1, 1, 1, 1],
                [1, 0, 1, 0, 0, 1, 1, 1, 0, 0, 0, 1, 0, 0, 0, 1, 1, 1, 0, 1, 2, 0, 0, 1],
                [1, 0, 1, 1, 0, 1, 0, 0, 0, 1, 0, 1, 0, 1, 0, 0, 1, 1, 0, 1, 1, 1, 0, 1],
                [1, 0, 1, 0, 0, 0, 0, 1, 0, 0, 1, 0, 0, 1, 1, 0, 1, 1, 0, 0, 1, 0, 0, 1],
                [1, 0, 1, 0, 1, 1, 0, 1, 1, 0, 1, 0, 1, 1, 0, 0, 0, 1, 1, 0, 1, 0, 0, 1],
                [1, 0, 0, 0, 1, 1, 0, 0, 1, 0, 0, 0, 0, 1, 0, 1, 0, 0, 1, 0, 1, 1, 0, 1],
                [1, 0, 1, 0, 0, 1, 0, 1, 1, 1, 0, 1, 1, 1, 0, 1, 1, 0, 0, 0, 1, 1, 0, 1],
                [1, 0, 1, 1, 0, 0, 0, 1, 0, 0, 0, 0, 0, 0, 0, 1, 0, 0, 1, 0, 1, 1, 0, 1],
                [1, 0, 1, 1, 0, 1, 1, 1, 0, 1, 1, 1, 0, 1, 1, 0, 0, 1, 0, 0, 0, 1, 0, 1],
                [1, 0, 1, 0, 0, 0, 1, 0, 1, 0, 1, 0, 0, 1, 1, 1, 0, 1, 0, 1, 0, 1, 0, 1],
                [1, 0, 1, 0, 1, 0, 0, 0, 1, 0, 0, 0, 1, 1, 0, 0, 0, 1, 1, 1, 0, 0, 0, 1],
                [1, 1, 1, 1, 1, 1, 1, 1, 1, 1, 1, 1, 1, 1, 1, 1, 1, 1, 1, 1, 1, 1, 1, 1]
            ],
            "cords": {
                "start": [1,6],
                "end": [20,2]
            }
        }
    ],
    "modded": false,
    "mapfileversion": "Beta - 1"
}